NO ./path_to_the_north_texture


SO                        ./path_to_the_south_texture




            WE                  ./path_to_the_west_texture



  EA ./path_to_the_east_texture


C 1,1,1
F 255,100,0








        111111111111 111111111111
        100000000011 100000000001111
        101100000111 1000000000011
        100100000001 100000000001
11111111101100000111 10000000 001
10000000001100000111 111111111111
11110111111111011101 10010001
11110111111111011101 10010001
11000000110101011101 10010001
10000000000000001101 10010001
10000000000000001101 10010001
11000001110101011111 11110N0111
11110111 1110101 101011010001
11111111 1111111 111 11111111