NO ./textures/test.xpm
SO ./textures/Boardgames_Card_Joker_Face.xpm
WE ./textures/test2.xpm
EA ./textures/coin.xpm


F 66,66,66
C 135,206,255


111111111111111111111111111111111111111111
100000000000000000000000000000000000000001
100000000000000000000000000000000000000001
100000000000000000000000000000000000000001
100000000000000000000000000000000000000001
10000000000000000E000000000000000000000001
100000000000000000000000000000000000000001
100000000000000000000000000000000000000001
100000000000000000000000000000000000000001
100000000000000000000000000000000000000001
100000000000000000000000000000000000000001
111111111111111111111111111111111111111111