NO ./textures/n.xpm
SO ./textures/s.xpm
WE ./textures/w.xpm
EA ./textures/e.xpm


F 66,66,66
C 135,206,235


111111111111111111111111111111111111111111
100001000000000000000000000000000000000001
100001111000000000000011111111100010000001
100000000000000000000000000000000000000001
100000000000000000000000000000000000000001
10010000111000000W000000000000000010000001
100000000000000000000000000000000000000001
100000000000000000000000000000000000000001
100000000000000000000000000000000000000001
100100000000000001111000000000111110000001
100100000000000000000000000000100000000001
111111111111111111111111111111111111111111