NO ./Textures/wall.xpm
SO ./textures/wall2.xpm
WE ./textures/wall3.xpm
EA ./textures/wall4.xpm


F 66,66,66
C 135,206,235


111111111111111111111111111111111111111111
100001000000000000000000000000000000000001
100001111000000000000011111111100010000001
10010000111000000N000000000000000010000001
100100000000000001111000000000111110000001
100100000000000000000000000000100000000001
111111111111111111111111111111111111111111